123
1 21 -1 -320 398 3488 32 2
2 43 -1 55 338 0 0 0 
3 43 -1 180 273 0 0 0 
4 43 -1 310 338 0 0 0 
5 43 -1 440 273 0 0 0 
6 43 -1 565 338 0 0 0 
7 43 -1 700 273 0 0 0 
8 43 -1 820 338 0 0 0 
9 43 -1 950 273 0 0 0 
10 43 -1 1080 338 0 0 0 
11 43 -1 1205 23 0 0 0  
12 43 -1 1335 148 0 0 0 
13 43 -1 1715 148 0 0 0 
14 43 -1 1850 338 0 0 0  
15 43 -1 1975 148 0 0 0  
16 43 -1 2100 338 0 0 0 
17 43 -1 2230 338 0 0 0 
18 43 -1 2355 338 0 0 0 
19 43 -1 2480 338 0 0 0  
20 43 -1 2605 338 0 0 0 
21 43 -1 2735 268 0 0 0  
22 43 -1 2870 148 0 0 0 
23 43 -1 3005 88 0 0 0  
24 43 -1 3245 148 0 0 0 
25 43 -1 3375 118 0 0 0 
26 43 -1 3125 343 0 0 0 
27 43 -1 3505 278 0 0 0 
28 21 -1 1376 273 96 32 2 
29 21 -1 1505 208 320 32 2 
30 21 -1 1855 273 160 32 2 
31 21 -1 2785 208 544 32 2 
32 21 -1 3200 398 384 32 2 
33 21 -1 3330 273 96 32 2
34 21 -1 3057 238 32 160 3
35 21 -1 3057 80 32 32 3
36 21 -1 3585 238 32 96 4
37 21 -1 3618 238 96 160 4
38 21 -1 3585 398 132 32 4
39 21 -1 3585 336 32 32 6
40 21 -1 3585 368 32 32 5
41 42 -1 3190 431 40 10 0
42 21 -1 2912 625 608 32 2
43 21 -1 3265 561 64 32 2
44 47 -1 3255 557 0 0 1

46 21 -1 3584 623 64 32 2
47 21 -1 3713 623 288 32 2
48 21 -1 4079 464 16 224 3
49 21 -1 4034 689 64 32 2
50 21 -1 3967 752 64 32 2
51 21 -1 4001 623 32 32 2
52 21 -1 3713 237 64 32 2
53 21 -1 3713 398 96 32 2
54 47 1 1248 397 0 0 1
55 48 1 1377 212 0 0 2
56 47 1 2594 397 0 0 1
57 48 1 2786 148 0 0 2
58 47 -1 3542 395 0 0 1
59 48 -1 3413 210 0 0 2
60 47 1 1441 272 0 0 1
61 48 1 1506 147 0 0 2
62 47 -1 1880 271 0 0 1
63 48 -1 1815 149 0 0 2
64 26 -1 3054 113 0 0 0 
65 42 -1 3985 717 40 40 0
66 42 -1 3460 778 504 30 0
67 42 -1 3180 158 20 60 0
68 21 -1 3426 273 32 32 4
69 48 -1 3150 345 0 0 2
70 21 -1 3168 398 32 32 4
71 43 -1 1595 338 0 0 0 
72 21 -1 2015 273 32 32 2 
73 43 -1 3121 498 0 0 0 
74 43 -1 3254 498 0 0 0 
75 43 -1 3505 498 0 0 0 
76 43 -1 3636 498 0 0 0 
77 43 -1 3760 498 0 0 0 
78 43 -1 3881 498 0 0 0 
79 43 -1 4017 498 0 0 0
80 43 -1 3382 498 0 0 0
81 42 -1 3807 468 30 20 0
82 47 -1 3960 623 0 0 1
83 48 -1 3797 338 0 0 2
84 21 -1 3809 398 32 32 4
85 21 -1 3841 398 6400 32 2
86 21 -1 3776 271 96 32 2
87 21 -1 3872 271 32 32 4

88 47 -1 3992 398 0 0 1
89 48 -1 3866 216 0 0 2

90 21 -1 3903 206 416 32 2
 
91 21 -1 4030 80 64 32 2
92 21 -1 4078 239 16 160 3
93 26 -1 4076 112 0 0 0
94 42 -1 4195 150 20 60 0

95 43 -1 3762 332 0 0 0
96 43 -1 3672 107 0 0 0
97 43 -1 3889 88 0 0 0
98 43 -1 4019 145 0 0 0

99 21 -1 4350 272 352 32 2
100 21 -1 5537 272 96 32 2
101 21 -1 5616 80 16 96 3
102 21 -1 5616 303 16 96 3

103 21 -1 5440 337 32 32 2
104 21 -1 5472 337 32 32 2
105 26 -1 5613 178 0 0 0

106 43 -1 4274 150 0 0 0
107 43 -1 4404 208 0 0 0
108 43 -1 4141 277 0 0 0
109 43 -1 4530 150 0 0 0

110 43 -1 4668 338 0 0 0
111 43 -1 4796 273 0 0 0
112 43 -1 4920 338 0 0 0

113 43 -1 5045 338 0 0 0
114 43 -1 5169 273 0 0 0
115 43 -1 5296 338 0 0 0

116 43 -1 5424 273 0 0 0
117 43 -1 5557 273 0 0 0

118 47 -1 4378 275 0 0 1
119 48 -1 4310 149 0 0 2

120 47 -1 4825 398 0 0 1
121 48 -1 4693 215 0 0 2

122 47 1 5472 336 0 0 1
123 48 1 5540 216 0 0 2
124 42 -1 5400 338 60 40 0

//124 26 -1 5554 338 20 20 0


 
id 71: Holy Water

id 72: brick -> a bonus

id 39: brick 4 ô -> chỉ effect
id 40: brick 3 ô ->Pot Roast


 
64 42 -1 3040 136 15 60 0

// id 64, type 42 Object ẩn dùng để mở cửa
 cần xóa id 64, object ẩn cửa

id 41: object ẩn -> xuống hồ nước
id 45: object ẩn -> trở lên trước khi xuống hồ nước
// id 64, type 26 Object ẩn dùng để mở cửa 
id 65: object ẩn -> bonus
id 66: object ẩn -> chạm nước -> chết
id 67: object ẩn -> box xác nhận simon đã qua cửa
// id 81: object ẩn -> ra khỏi hồ nước phía phải
id 86: object ẩn -> vào hồ nước phía phải
